
NO  ./pics/eagle.xpm
SO  ./pics/eagle.xpm
EA  ./pics/wall_2.xpm
WE  ./pics/wall_1.xpm
S   ./pics/pilarrubio.xpm
C   50,50,70
F   40,40,40
11111111111111111111111111111
12222222201100000000000000001
10000000011100000000000010001
10000S00000000000000000010001
10000000000000000000000010001
10000000001100000111011110001
11110111111111011100000010001
11110111111111011101010010001
11000000110101011100000010001
10000000000000001100000010001
10000000000000001101010010001
11000000110101000000000000001
10000000110101000000000000001
10000000001100000100000010001
10000000000000001010000101001
10002000001000010001010001001
10020200001101000000000000001
10000000000100000001010000001
11111111111111111111111111111
