R 6000 6000
1 1 1 1 1 1 1 1 1
1 0 0 0 0 0 0 0 1
1 0 0 0 1 1 0 0 1
1 0 0 0 1 E 0 0 1
1 1 1 1 1 1 1 1 1

